############
#..........#
#..........#
#..........#
#.........U#
############