###############################################################
#.............................................................#
#..................#####.............#.#########..............#
#..................#####.............#.........#..............#
#..................####..............#.........#..............#
#..................#####.............##........#..............#
#..................#######.............#.......#..............#
#..................###..................########..............#
#..................###........................................#
#............................@................................#
#.............................................................#
#................................................D............#
#...............##########....................................#
#..................##.........................K...............#
#.............................................................#
#.............................................................#
#.............................................................#
###############################################################